F 144,238,144
C 173,216,230


NO ./img/blue_planks.xpm
SO ./img/yellow_planks.xpm
EA ./img/green_planks.xpm
WE ./img/red_planks.xpm


        111111111111111111111111
        1000000000110000000100001
        1011000001110010000000001
        100100000000000000N010001
111111110110000011100000000000111
10000000001100000111011111111111
1111011111111101110000010001
111101111111110111010100100111
1100000011010101110000001000011
10000001000000001100000010000101
1000001 100000000001101010010001
1100000111010101111101111000111
11110111 1110101 101111 1000001
11111111 11111111 111111111111
