F 144,238,144
C 173,216,230


NO ./img/blue_planks.xpm
SO ./img/yellow_planks.xpm
             
          WE ./img/red_planks.xpm

			EA ./img/green_planks.xpm


        1111111111111111111111111
        1000000000110000000100001
        1011000001110010000000001
        1001000000000000000010001
11111111011000001110000000N00001
100000000011000001110111111111111
11110111111111011100000010001
11110111111111011101010010001
11000000110101011100000010001
10000000000000001100000010001
10000000000000001101010010001
1100000111010101111101111000111
11110111 1110101 101111010001
111111111111111111111111111111111